##########
#........#
#........#
#..p..b..#
#.....b..#
#........#
#........#
#......t.#
#......t.#
##########