
         11111111
         1.....p1
         1.b1b.11
         1.b...b1
         11b.b.1
 111111111.b.1.111
 1tttt..11.b..b..1
 11ttt....b..b...1
 1tttt..1111111111
 11111111