
   111111111111
   1tt..1.....111
   1tt..1.b..b..1
   1tt..1b1111..1
   1tt....p.11..1
   1tt..1.1..b.11
   111111.11b.b.1
     1.b..b.b.b.1
     1....1.....1
     111111111111